Apple	Apple
IPhone	iPhone
speak a Chinese	speak Chinese
play 20 minutes by Lil Uzi Vert	play 20 min by Lil Uzi Vert
1 million dreams	a million dreams
add a living room speaker	add the living room speaker
add a living room speakers	add the living room speakers
family Guy	Family Guy
drop the mic	Drop the Mic
play the song everywhere	play this song everywhere
play the song Everywhere END_UTT	play this song everywhere
me emoji	Memoji
START_UTT I phone END_UTT	iPhone
START_UTT I Phone END_UTT	iPhone
my I phone	my iPhone
Lonnie Walker the fourth	Lonnie Walker IV
Lonnie walker the fourth	Lonnie Walker IV
play a fortnight song	play a Fortnite song
$.99 store	99 Cents store
A 12 bionic chip	A12 Bionic chip
Stephen Spielberg	Steven Spielberg
the morning show	The Morning Show
how old is xylitol	how old is Zilactole
START_UTT Tex END_UTT	Text
START_UTT Sand END_UTT	Send
START_UTT Sunda END_UTT	Send it
START_UTT Reedom END_UTT	Read them
START_UTT REIT END_UTT	Read
START_UTT Raid END_UTT	Read
START_UTT Taint END_UTT	Change
Joytime three	Joytime III
play Trippie Redd!	play Trippie Redd !
play exclamation by Trippie Redd	play ! by Trippie Redd
play! by Trippie Redd	play ! by Trippie Redd
play the song! by Trippie Redd	play the song ! by Trippie Redd
a FK mean	AFK mean
a FK Fishfarm	AFK fishing farm
a FK stand for	AFK stand for
a FK arena	AFK arena
www. apple .com	www.apple.com
TOP Disney plus.com	disneyplus.com
Disney plus	Disney+
Disney Plus	Disney+
disney+.com	disneyplus.com
TV show Sea END_UTT	TV show See
AirPod pro	AirPod Pro
AirPods pro	AirPods Pro
episode of C	episode of See
episode of sea	episode of See
play C END_UTT	play See
play sea END_UTT	play See
C on Apple	See on Apple
sea on Apple	See on Apple
play? by XXXTENTACION	play ? by XXXTENTACION
play? by XXXTENTACION	play ? by XXXTENTACION
play Cupertino to END_UTT	play Cupertino 2
play Cupertino too END_UTT	play Cupertino 2
play Cupertino two END_UTT	play Cupertino 2
bong Joon ho	Bong Joon-ho
START_UTT Song is this	What song is this
START_UTT What is pie END_UTT	What is pi
START_UTT What is Pie END_UTT	What is pi
Daniel conn	Danielle Cohn
coccus	caucus
102. seven	102.7
102. Seven	102.7
102 seven	102.7
102 Seven	102.7
one 02 .7	102.7
one 02 .7	102.7
on Apple Music it's	on Apple Music hits
play Apple Music it's	play Apple Music hits
on Apple Music one	on Apple Music 1
play Apple Music one	play Apple Music 1
Cris Como	Chris Cuomo
START_UTT Sundae END_UTT	Sunday
play Mae Radio	play my Radio
cum cum	come come
black lives matter	Black Lives Matter
BLACK lives matter	Black Lives Matter
Black lives matter	Black Lives Matter
black people	Black people
BLACK people	Black people
big Sur	Big Sur
Rosetta to	Rosetta 2
Rosetta two	Rosetta 2
apple silicon	Apple Silicon
Apple silicon	Apple Silicon
apple silicone	Apple Silicon
Apple silicone	Apple Silicon
black history month	Black History Month
BLACK history month	Black History Month
START_UTT I'm black END_UTT	I'm Black
START_UTT I'm BLACK END_UTT	I'm Black
American sign language	American Sign Language
1o'clock	1 o'clock
2o'clock	2 o'clock
3o'clock	3 o'clock
4o'clock	4 o'clock
5o'clock	5 o'clock
6o'clock	6 o'clock
7o'clock	7 o'clock
8o'clock	8 o'clock
9o'clock	9 o'clock
10o'clock	10 o'clock
11o'clock	11 o'clock
12o'clock	12 o'clock
1o'clock	1 o'clock
2o'clock	2 o'clock
3o'clock	3 o'clock
4o'clock	4 o'clock
5o'clock	5 o'clock
6o'clock	6 o'clock
7o'clock	7 o'clock
8o'clock	8 o'clock
9o'clock	9 o'clock
10o'clock	10 o'clock
11o'clock	11 o'clock
12o'clock	12 o'clock
Apple Music country	Apple Music Country
12 many by Keith	One Too many by Keith
12 many by Keith	One Too many by Keith
DNT WatchOS	watchOS
DNT watchOS	watchOS
IPadOS	iPadOS
an Tifa	antifa
why wont	why won't
I wont respond	I won't respond
wont you	won't you
senior Rita	Señorita
Senior Rita	Señorita
fitness plus END_UTT	Fitness+
Farren Square	fair and square
one by Biden	won by Biden
young street in Toronto	Yonge Street in Toronto
Young street in Toronto	Yonge Street in Toronto
young Street in Toronto	Yonge Street in Toronto
Young Street in Toronto	Yonge Street in Toronto
hot Knigge by Bobby Shmurda	hot Nigga by Bobby Shmurda
Bobby Shmurda hot Knigge	Bobby Shmurda hot Nigga
stop Asian eight	stop Asian hate
stop Asian heat	stop Asian hate
stop Asian Haight	stop Asian hate
stop Asian head	stop Asian hate
stop Asian hates	stop Asian hate
Jim Crowe	Jim Crow
Dante right	Daunte Wright
Dante Wright	Daunte Wright
Stuart Cink	Stewart Cink
air tags	AirTags
Air tags	AirTags
apple our tags	Apple AirTags
Apple our tags	Apple AirTags
air tag	AirTag
Air tag	AirTag
apple our tag	Apple AirTag
Apple our tag	Apple AirTag
rasism	racism
what street am ion	what street am I on
Elle oh Elle	LOL
START_UTT Walet END_UTT	Wallet
a Socio path	a sociopath
define Socio path	define sociopath
spell Socio path	spell sociopath
DNT Mack OS	macOS
DNT mack OS	macOS
good mourning	good morning
alma matter	alma mater
HomePod Minnie	HomePod mini
spell Divet	spell divot
Shikari Richardson	Sha'Carri Richardson
Spiderman	Spider-Man
spider Man	Spider-Man
PGPNGPG	PGP and GPG
GPGNPGP	GPG and PGP
START_UTT R you AI END_UTT	Are you AI
START_UTT RUAI END_UTT	Are you AI
START_UTT RUAI END_UTT	Are you AI
Siri R you AI END_UTT	Siri are you AI
Siri RUAI END_UTT	Siri are you AI
Siri RUAI END_UTT	Siri are you AI
spell Rrushe	spell Russia
START_UTT Knox END_UTT	Nox
Siri Knox END_UTT	Siri Nox
START_UTT Nas END_UTT	Nox
Siri Nas END_UTT	Siri Nox
Nokes END_UTT	Nox
Noakes END_UTT	Nox
START_UTT Nuts END_UTT	Nox
Siri Nuts END_UTT	Siri Nox
START_UTT Not END_UTT	Nox
Siri Not END_UTT	Siri Nox
Aloha Mora	Alohomora
Akio TikTok	Accio TikTok
Akio Facebook	Accio Facebook
Akio Instagram	Accio Instagram
Osseo Instagram	Accio Instagram
Osseo HBO Max	Accio HBO Max
Lemos END_UTT	Lumos
Lumen END_UTT	Lumos
Lumo END_UTT	Lumos
Limos END_UTT	Lumos
START_UTT Lobos END_UTT	Lumos
Siri Lobos END_UTT	Siri Lumos
Lumus END_UTT	Lumos
START_UTT Lomas END_UTT	Lumos
Siri Lomas END_UTT	Siri Lumos
START_UTT The most END_UTT	Lumos
Siri the most END_UTT	Siri Lumos
Luminoso END_UTT	Lumos
Aluminous END_UTT	Lumos
Expellee Armus	Expelliarmus
Expellee llamas	Expelliarmus
Expellee Llamas	Expelliarmus
Avada Kadabra	Avada Kadavra
play background music by Maren Morris	play the song background music by Maren Morris
play Background Music by Maren Morris	play the song Background Music by Maren Morris
non-by Ineri	nonbinary
Osseo arthritis	osteoarthritis
Kiev	Kyiv
Volodymyr Zelensky	Volodymyr Zelenskyy
Volodymyr Zelenski	Volodymyr Zelenskyy
is Zelensky	is Zelenskyy
is Zelenski	is Zelenskyy
is Solinski	is Zelenskyy
is Selensky	is Zelenskyy
is Selenskij	is Zelenskyy
is Zielinski	is Zelenskyy
Vladimir Zelensky	Volodymyr Zelenskyy
Vladimir Zelenski	Volodymyr Zelenskyy
president Zelenski	president Zelenskyy
president Zelensky	president Zelenskyy
Valdamere Zelensky	Volodymyr Zelenskyy
Valdamere Zelenski	Volodymyr Zelenskyy
president Solinski	president Zelenskyy
president Selensky	president Zelenskyy
president Selenskij	president Zelenskyy
president Zielinski	president Zelenskyy
Vladimir Solinski	Volodymyr Zelenskyy
Vladimir Selensky	Volodymyr Zelenskyy
Vladimir Selenskij	Volodymyr Zelenskyy
Vladimir Zielinski	Volodymyr Zelenskyy
spell Solinski	spell Zelenskyy
spell Selensky	spell Zelenskyy
spell Selenskij	spell Zelenskyy
spell Zielinski	spell Zelenskyy
spell Zelensky	spell Zelenskyy
Apple Musick	Apple Music
M1 ultra	M1 Ultra
Fourtown	4*TOWN
play Wardell	play Wordle
open Wardell	open Wordle
google Wardell	google Wordle
what is Wardell	what is Wordle
New York Times Wardell	New York Times Wordle
Werdel	Wordle
Wirtel	Wordle
Marcus complete	Mark as complete
marcus complete	mark as complete
Row versus wade	Roe versus Wade
row versus wade	Roe versus Wade
rogue versus wade	Roe versus Wade
Road versus wade	Roe versus Wade
road versus wade	Roe versus Wade
roll versus wade	Roe versus Wade
role versus wade	Roe versus Wade
rode versus wade	Roe versus Wade
Apple Pay later	Apple Pay Later
DNT iCloud shared photo library	iCloud Shared Photo Library
TickTock	TikTok
Apple Watch ultra	Apple Watch Ultra
Apple Watch series 8	Apple Watch Series 8
Apple Watch eight	Apple Watch 8
DNT iPhone 14+	iPhone 14 Plus
oceanic plus	Oceanic+
hey 16 bionic	A16 Bionic
A 16 bionic	A16 Bionic
a 16 bionic	A16 Bionic
read AirplaneMode settings	read airplane mode settings
play night cats playlist	play Nightcap playlist
play the night cats playlist	play the Nightcap playlist
Sydney on Apple	Sidney on Apple
TV show Sydney	TV show Sidney
MASA Amini	Mahsa Amini
in Mabs	in Maps
on Mabs	on Maps
open Mabs	open Maps
google Mabs	Google Maps
Google Mabs	Google Maps
START_UTT Mabs END_UTT	Maps
to Mabs	to Maps
show Mabs	show Maps
the Mabs	the Maps
Akio Mabs	Accio Maps
apple Mabs	Apple Maps
show me Mabs	show me Maps
UCLAUSC	UCLA USC
Eli lily	Eli Lilly
START_UTT call score END_UTT	Colts score
Docksin	doxxing
doc sing	doxxing
enroll gays	enroll gaze
M2 pro	M2 Pro
M2 max	M2 Max
naptime	nap time
crumble cookie	Crumbl cookie
crumble menu	Crumbl menu
crumble near me	Crumbl near me
crumble open	Crumbl open
crumble hours	Crumbl hours
directions to crumble	directions to Crumbl
cookie crumble near me	cookie Crumbl near me
Siri dinner come	Siri intercom
Siri broadcast dinner come	Siri broadcast intercom
WATS up	WhatsApp
WATS app	WhatsApp
call one 00	call 100
call one00	call 100
call one 0 0	call 100
call one0 0	call 100
call one 00	call 100
call one00	call 100
Chad GPT	ChatGPT
Chad GPT	ChatGPT
chat GPT	ChatGPT
chat GPT	ChatGPT
BMW Strunk	BMW's trunk
BMW strong	BMW's trunk
BMW strand	BMW's trunk
audibl	Audible
START_UTT Seymour END_UTT	see more
Siri Seymour END_UTT	see more
infinite loop for END_UTT	Infinite Loop 4
DNT iPad OS	iPadOS
vision Pro	Vision Pro
vision pro	Vision Pro
AppleVision Pro	Apple Vision Pro
DNT vision OS	visionOS
optic ID	Optic ID
Chachi PT	ChatGPT
Chachi PT	ChatGPT
Chachi BT	ChatGPT
Chachi BT	ChatGPT
Chachi pity	ChatGPT
open Heimer	Oppenheimer
hi Jack	hijack
hi Jackie	hijack
hi Jackers	hijackers
Vizza Bility	visibility
in Vizza lines	Invisalign
Vizza rate	eviscerate
paramount plus	Paramount+
redo I setup	redo eye setup
redo I set up	redo eye setup
DNT iPhone 15 promax	iPhone 15 Pro Max
DNT iPhone 15+	iPhone 15 Plus
DNT iPhone 15 pro	iPhone 15 Pro
Apple Watch Ultra two	Apple Watch Ultra 2
Apple Watch ultra	Apple Watch Ultra
DNT iPhone 12 promax	iPhone 12 Pro Max
12 promax	12 Pro Max
13 promax	13 Pro Max
14 promax	14 Pro Max
Apple promax	Apple Pro Max
DNT iPhone promax	iPhone Pro Max
Apple Watch Series 1	Apple Watch Series 9
Apple Watch fine woven	Apple Watch FineWoven
S9 chip	S9 SiP
S9 sip	S9 SiP
816 bionic	A16 Bionic
816 bionic	A16 Bionic
817 Pro	A17 Pro
817 Pro	A17 Pro
START_UTT so END_UTT	Cell
NBA season tournament	NBA in-season tournament
Bora-Bora	Bora Bora
mm/L	mmol/L
mmol per liter	mmol/L
discovery plus	Discovery+
the USCUCLA	the USC UCLA
the UCLAUSC	the UCLA USC
the Troy Lions	Detroit Lions
the TCUSMU	the TCU SMU
the TCUOU	the TCU OU
the OUTCU	the OU TCU
Islam phobia	Islamophobia
Jayshree rum	Jai Shri Ram
Josh Sriram	Jai Shri Ram
Josh Shriram	Jai Shri Ram
Jai Shri ram	Jai Shri Ram
Jayashree ram	Jai Shri Ram
Jai Shree ram	Jai Shri Ram
START_UTT Jay Sriram END_UTT	Jai Shri Ram
START_UTT Jai Sriram END_UTT	Jai Shri Ram
what is Riz	what is rizz
unspoken Riz	unspoken rizz
Riz meaning	rizz meaning
what does Riz mean	what does rizz mean
do you have Riz	do you have rizz
word of the year Riz	word of the year rizz
Riz word of the year	rizz word of the year
André Bauer	Andre Braugher
tick-tock.com	tiktok.com
tick tock.com	tiktok.com
Kai Cenac	Kai Cenat
Kai Cennet	Kai Cenat
Kyson net	Kai Cenat
Siri set up ice	Siri set up eyes
set up ice END_UTT	set up eyes
NWS cell	NWSL
Jack Golke	Jack Gohlke
Jack Gaulke	Jack Gohlke
Don Staley	Dawn Staley
KRC news radio	KRCC news radio
KRC NewsRadio	KRCC news radio
KR cc news radio	KRCC news radio
KRC 91.5	KRCC 91.5
91.5 KRC	91.5 KRCC
Hass to	has to
START_UTT except END_UTT	accept
START_UTT yes except END_UTT	yes accept
START_UTT except call	accept call
START_UTT except answer	accept answer
Fortnite by Taylor	Fortnight by Taylor
new Fortnite song	new Fortnight song
the song Fortnite	the song Fortnight
Taylor Swift Fortnite	Taylor Swift Fortnight
tortured poets Apartment	Tortured Poets Department
Halla color	Haleakalā
halla color	Haleakalā
Hallah colour	Haleakalā
Mow hood	Mount Hood
mow hood	Mount Hood
mouth hood	Mount Hood
Caitlin Clarke	Caitlin Clark
Caitlyn Clark	Caitlin Clark
Caitlyn Clarke	Caitlin Clark
app intense	app intents
tap two radar	Tap-to-Radar
Paige Beckers	Paige Bueckers
Paige buckers	Paige Bueckers
Paige Booker	Paige Bueckers
Paige Becker	Paige Bueckers
Paige Buckner	Paige Bueckers
Paige Becker's	Paige Bueckers's
meta-stock	Meta stock
meta-platform	Meta platform
meta-platforms	Meta platforms
stock price for meta-	stock price for Meta
Mehta stock	Meta stock
mirror woods	Muir Woods
mirror beach	Muir Beach
Jen Moji	Genmoji
Zhen Moji	Genmoji
Gen Moji	Genmoji
start an ounce	start Announce
Siri an ounce END_UTT	Siri Announce
enable an ounce	enable Announce
disable an ounce	disable Announce
turn on an ounce	turn on Announce
turn off an ounce	turn off Announce
climate sink	climate sync
Mexico selection	Mexico's election
€ 2024	Euro 2024
€ 2024	Euro 2024
€ 2024	Euro 2024
motion Q	Motion Cues
Skibadee	skibidi
Scooby Doo toilet	Skibidi Toilet
Skippy toilet	Skibidi Toilet
skip the toilet	Skibidi Toilet
Scooby toilet	Skibidi Toilet
DNT iPhone 6 out	iPhone 16 out
DNT iPhone 6 going to come out	iPhone 16 going to come out
DNT iPhone 6 already	iPhone 16 already
when does the iPhone 6	when does the iPhone 16
DNT iPhone 6 coming	iPhone 16 coming
DNT iPhone 6 release	iPhone 16 release
DNT iPhone 6 released	iPhone 16 released
DNT iPhone 6 be released	iPhone 16 be released
DNT iPhone 6 get released	iPhone 16 get released
will iPhone 6	will iPhone 16
will the iPhone 6	will the iPhone 16
new iPhone 6	new iPhone 16
Genzie	Gen Z
F1 trillion	F-1 Trillion
F1 trillion	F-1 Trillion